11111111111111
1P0001000000C1
101C0100100101
101000001C0101
10111111110101
1010010C010101
10100000000001
101101001111E1
10110111100001
1C0000000010C1
11111111111111